NO textures/N.png
SO textures/S.png
WE textures/W.png
EA textures/E.png
DO textures/barrel.png


F 0, 0, 0
C 0, 0, 0

1111111111111111111
1001001001001000001
1011000001000011101
100100100D111101111
100111100N001001001
1000000000100101001
1001111111111001001
1111000000001001011
1000000001000000001
1111111111111111111