NO ./path_to_the_north_texture
SO ./path_to_the_south_texture
WE ./path_to_the_west_texture
EA ./path_to_the_east_texture

F 220,100,0
C 225,30,0

1111111111111111111111111111111111111111111111111111111111111111
1000000000000000000000000000000000000000000000000000000000000001
1001111100111110000000000000000000000000000011111000111110000001
1001000000000010000000000000000000000000000000000000000010000001
1001001111110010000000000000000000000000000000001111110010000001
1000001000010000000000000000000000000000000000001000010000000001
1000001000010000000000000000000000000000000000001000010000000001
1001001000010010000000000000000000000000000000001000010010000001
1001000000000010000000000000000000000000000000000000000010000001
1001111111111110000000000000000000000000000000001111111110000001
1000000000000000000000000000000000000000000000000000000000000001
1111111111111111111111111111111111111111111111111111111111111111
1000000000000000000000000000000000000000000000000000000000000001
1011000000000000000000000000000000000000000000000000000000000001
1001000000000000000000000000000000000000000000000000000000000001
1111111101100000111000000000000000000000000000000000000000000001
1000000000110000011101111111111111111111111111111111111111111111
1111011111111101110000001000100000000000000000000000000000000001
1111011111111101110101000000100000000000000000000000000000000001
1100000011010101110000001000100000000000000000000000000000000001
100000000000000011000000100010000000000000000N000000000000000001
1000000000000000110101001000100000000000000000000000000000000001
1100000111010101111101111001110000000000000000000000000000000001
1111011111110101101111010000010000000000000000000000000000000001
1111111111111111111111111111111111111111111111111111111111111111