NO      textures/N.png
SO textures/Ss.png
WE                    textures/W.png









                     EA textures/E.png
DO textures/door.png


F 0         ,  0,       0
C       0,      0, 0

1111111111111111111
10000000000000000001
1000000000000001001
1D11111111111000001
1010000000001111111
101000100000D000001



1011000001001001001
1000000000001000001
1111111111111111D11
1E00000000000D00001
1111111111111111111