NO textures/N.png
SO textures/S.png
WE textures/W.png
EA textures/E.png


F 0, 0, 0
C 0, 0, 0

1111111111111111111
1001001001001000001
1011000001000001001
1001001001111101111
100111100W001001001
1000000000000001001
1001111111111001001
1111000000000001011
1000000001000000001
1111111111111111111